11111111
1P000E01
10000001
10100101
10100101
10000001
100000E1
11111111