11111111
1PS00S01
1K1111K1
1D1111D1
1N0000N1
100110N1
1HHHH0E1
11111111