11111111
1P100101
10100S01
10100101
10S00101
10100101
101001E1
11111111