11111111
1P0S01K1
10010101
10010101
11D10S01
10011111
100000E1
11111111