11111111
1P000001
10000001
10000001
11110111
10000001
1000N0E1
11111111