11111111
1P000NK1
101N0001
10000101
100000K1
1D111111
1D0000E1
11111111