11111111
1P000001
1011SS11
1N1K0001
1N100001
1D111111
100000E1
11111111