11111111
1P000001
10110001
1S100001
10001101
10001H01
100000E1
11111111