11111111
1P000001
101S1001
101K0001
101000N1
10001111
1N00HDE1
11111111