11111111
1P0S00H1
10010001
100S0N01
101111D1
1000K101
1N0SH1E1
11111111